xxxxxxxxxxxxxxxxxxxxxxxxxxxxxxxxxxxxxxxxxxxxxxxxxxxxxxxxxxxxxxxxxxxxxxxxxxxxxx
x----------------------------------------------------------------------------x
x----------------------------------------------------------------------------x
x-----------------------------x---------------------------------------FFFF---x
x---------------x-----------------------------------------------------F------x
x----------x----------x----x-----------------------x------------------F------x
x---M-----xx---E----E------x----E------x-E------E--x-----E------------F------x
xxxxxxxxxxxxxxxxxxxxxxxxxxxxxxxxxxxxxxxxxxxxxxxxxxxxxxxxxxxxxxxxxxxxxxxxxxxxxx