x x x x x x x x x x x x x x x x x x x x x x x x x x x x x x x x x x x x x x x x x x x x x x x x x x x x x x x x x x x x x x x x x x x x x x x x x x x x x x
x - - - - - - - - - - - - - - - - - - - - - - - - - - - - - - - - - - - - - - - - - - - - - - - - - - - - - - - - - - - - - - - - - - - - - - - - - - - - x
x - - - - - - - - - - - - - - - - - - - - - - - - - - - - - - - - - - - - - - - - - - - - - - - - - - - - - - - - - - - - - - - - - - - - - - - - - - - - x
x - - - - - - - - - - - - - - - - - - - - - - - - - - - - - x - - - - - - - - - - - - - - - - - - - - - - - - - - - - - - - - - - - - - - - F F F F - - - x
x - - - - - - - - - - - - - - - x - - - - - - - - - - - - - - - - - - - - - - - - - - - - - - - - - - - - - - - - - - - - - - - - - - - - - F - - - - - - x
x - - - - - - - - - - x - - - - - - - - - - x - - - - x - - - - - - - - - - - - - - - - - - - - - - - x - - - - - - - - - - - - - - - - - - F - - - - - - x
x - - - M - - - - - x x - - - E - - - - E - - - - - - x - - - - E - - - - - - x - E - - - - - - E - - x - - - - - E - - - - - - - - - - - - F - - - - - - x
x x x x x x x x x x x x x x x x x x x x x x x x x x x x x x x x x x x x x x x x x x x x x x x x x x x x x x x x x x x x x x x x x x x x x x x x x x x x x x